0000000000000000000000000
0000000000000000000000000
0000000000000000000000000
0000000000000000011100100
0000000000011101111100110
0011111110011101111111100
0111101111011101101010100
0111111111011111101010100
0111111111011111111111100
0110000011011111101010100
0110000011111100101010100
0110000011111100111111110
0110000011011100000000000
0110000011011000000000000
0111111111011000000000000
0000000000011000000000000
0000000000011100011111110
0000000000001100011101110
0000000000001100000101110
0000000000011100000111110
0000111111011100000110000
0000111111011100000110000
0000111111111100000110000
0000111111111100001110000
0000010011011100111111000
0000000000001100111101000
0000000000001111111100000
0000000000001111111100000
0000000000011100001111000
0000000000000000000000000
