000000000000000000000000000000
000000000000000000000000000000
000000000000000000000000000000
000111111100000000000000011110
011111111111100000001111111110
001111111111100000001111111110
000111111111111111111111001110
001110011111111111111111000000
000000000000000000110000000000
000000000000000000110000000000
000000000000000000110000000000
001111111111111000110000000000
001100111111111000110011111100
000000111111111000110011111100
000000111111111111111111111100
001111111100011111111100000110
000000011100011111111100000110
000000011100011000110111111110
001111111111111000110111111110
000000000000000000000000000000